
#################
#.........###...#
#.......###.....#
#...............#
#############...#
#############...#
#############...#
#############...#############
#############...............#
#############.......###.....#
#############...............#
#############...............#
#############.......###.....#
#############...............#
#############################